^^^^^^^^^^^^^^^^^^^^^^^^^^^^^^
^^^^^^            ^^^^^^ ^^^^^
^^^^^^ ^^^^^^^^^^ ^^^^^^ ^^^^^
^^^^^^ ^^^^^^^^^^ ^^^    ^^^^^
P      ^^^^^^^^^^ ^^  ^^ ^^^^^
^^^^^^ ^^^^^^^^^^ ^^ ^^^ ^^^^^
^^^^^^ ^^^^^^^^^^ ^  ^^^ ^^^^^
^^^^^^ ^^^^^^^^^^ ^ ^^^^ ^^^^^
^^^^^^ ^^^^^^^^^^   ^^^^ ^^^^^
^^^^^^ ^^^^^^^^^^^^^^^^^ ^^^^^
^^^^^^ ^^^^^^^^^^^^^^^^^ ^^^^^
^^^^^^ ^^^^     ^^^^^^^^    ^^
^^^^^^ ^^^^ ^^^ ^^^^^^^^ ^^^^^
^^^^^^ ^^^^ ^^^ ^^^^^^^^ ^^^^^
^^^^^^ ^^^^ ^^^ ^^^^^^^^ ^^^^^
^^^    ^^^^ ^^^ ^^^^^^^^ ^^^^^
^^^ ^^^^^^^ ^^^ ^^^^^^^^ ^^^^^
^^^ ^^^^^^^ ^^^ ^^^^^^^^ ^^^^^
^^^ ^^^^^^^ ^^^ ^^^^^^^^ ^^^^^
^^^ ^^^^^^^ ^^^ ^^^^^^^^ ^^^^^
^^^         ^^^ ^^^^^^^^ ^^^^^
^^^^^^ ^^^^^^^^ ^^^^^^^^ ^^^^^
^^^^^^ ^^^^^^^^ ^^^^^^^^ ^^^^^
^^^^^^    ^^^^^ ^^^^^^^^ ^^^^^
^^^^^^^^ ^^^^^^ ^^^^^^^^ ^^^^^
^^^^^^^^ ^^^^^^ ^^^^^^^^ ^^^^^
^^^^^^^^ ^^^^^^ ^^^^^^^^ ^^^^^
^ ^^^^^^ ^^^^^^ ^^^^^^^^ ^^^^^
^ ^^^^^^ ^^^^^^ ^^^^^^^^ ^^T^^
^ ^^^^^^ ^^^^^^ ^^^^^^^^ ^^ ^^
^ ^^^^^^ ^^^^^^ ^^^^^^^^ ^^ ^^
^ ^^^^^^ ^^^^^^ ^^^^^^^^ ^^ ^^
^ ^^^^^^ ^^^^^^ ^^^^^^^^ ^^ ^^
^ ^^^^^^ ^^^^^^ ^^^^^^^^ ^^ ^^
^ ^^^^^^ ^^^^^^ ^^^^^^^^ ^^ ^^
^ ^^^^^^ ^^^^^^ ^^^^^^^^ ^^ ^^
^ ^^^^^^ ^^^^^^ ^^^^^^^^ ^^ ^^
^ ^^^^^^ ^^^^^^ ^^^^^^^^ ^^ ^^
^        ^^^^^^ ^^^^^^^^ ^^ ^^
^^^^^^^^^^^^^^^ ^^^^^^^^ ^^ ^^
^^^^^^^^^^^^^^^       ^^^^^ ^^
^^^^^^^^^^^^^^^ ^^^^^ ^^^^^ ^^
^^^^^^^^^^^^^^^ ^^^^^ ^^^^^ ^^
^^^^^^^^^^^^^^^^^^^^^       ^^
^^^^^^^^^^^^^^^^^^^^^^^^^^^^^^
^^^^^^^^^^^^^^^^^^^^^^^^^^^^^^